2 1 2 2 2 2 2 2 2 2 2 2 2 2 2 2 2 2 2 2 2 2 2 2 2
1 0 7 6 0 0 0 1 0 0 0 0 0 0 0 0 0 0 0 0 0 0 0 0 3
1 0 1 6 0 0 0 1 0 0 0 0 0 0 0 0 0 0 0 0 0 0 0 0 3
1 0 0 6 0 0 0 1 0 0 1 1 1 1 0 0 0 0 0 0 0 0 0 0 3
1 0 6 6 0 0 0 1 0 0 0 0 0 0 0 1 0 0 1 1 1 1 1 1 3
1 0 2 0 0 0 0 1 0 0 1 0 0 0 0 1 0 0 0 0 0 0 0 0 3
1 0 2 0 0 1 0 1 0 0 1 0 0 0 0 1 0 0 0 0 0 0 0 0 3
1 0 0 0 0 7 0 0 0 0 1 0 0 0 0 1 0 0 0 0 0 0 0 0 3
1 0 0 0 0 7 7 0 0 1 7 1 1 0 0 1 0 0 0 0 1 1 1 1 3
1 0 0 0 0 0 0 0 0 0 0 0 0 0 0 0 0 0 0 0 0 0 0 0 3
1 0 0 0 0 0 0 0 0 0 0 0 0 0 0 1 1 0 1 1 1 0 0 0 3
1 0 0 0 0 7 0 0 0 0 0 0 0 0 0 1 1 0 1 0 1 0 1 1 3
1 0 0 0 0 7 0 0 0 0 0 0 x 0 0 0 0 0 0 0 1 0 0 0 3
1 0 0 0 0 7 7 0 0 0 0 0 0 0 0 0 0 0 0 0 0 0 0 0 3
4 4 4 4 4 4 4 4 4 4 4 4 4 4 4 4 4 4 4 4 4 4 4 4 3